kind - a
think - p
noise - r
let - d 
anythig - al
cold - f
complain - q
when - cu
some - alg
meet - co
give- d y e 
make - h
know - co
only - s
hear - o
which - cua
wear - v
find - enc
forget - olv
leave - sa
should - 
out - afu
able- ca
care - p
each - c
often - a me
belive  - c
wake up - d
while - mi
hurt - h
bucket - c
loud - r
pour - s
fill - ll
keep - gu
turn - gi

through - a t d
keep g
every - ca
set p c f 
most - l m
sell - v
thing c s c
tell - c
until,till - h q , h
bury - en
eye - o
lay - a
cover - c
stare - 
dream - sñ
wet h

quick - r
steal 
issu - c p a 
sharp - a
knife - cu
want - q d 
stick - pagar pegalo 
climb-tre
sick - enf
sudden - repe
lie - m 
shake  ag
groubd - sue,tie
floor sue
matter - asun 
tell c d 

injure heri
stay p
wrist - muñe
nise - ru
tell - c

froward - h a
sudden - re
step - p d u p
bring - ll
a few - unos p unos c p

carry ll tran
actually - en r
hang - col
wall par
floor - s
noise rui
mouth - 
taste - prob
afraid - con m t 
weekend - f d sem
chair - sill
wall pare
huge enor

which cual 

grab - agarr


allow permi
wet h 




wall - pa
allow - per
tie - corba
issue - probl
sudden - repen
grab - agarra
hadle  - mania
wood - bosque
tear - romper
weigh - pesar
burn - quemar
judge - juzga
deaf - sordo
ear  - oreja
travel - viajar 
safe - seguro
instead - en su lugar 
dish - plato
makeup- 
injure - herr
wrist - muñeca
through - a travez de 
set - pon
want - q d 
forward  - adelante 
lay  - acosta
tear  - rasgar
carry . leeva
afraid temeros 
fill llenar

stick pega